########################
#.............p........#
#......................#
#..........@...........#
#......................#
########################