########################################
#              #             #         #
# ############ ##### ####### # #### ## #
#              #    B      #        ## #
## ####### ### ########### ## ######## #
#    @    .#               #  #        #
# ### #### # # ############## #### ### #
#          #                  #        #
# ######### ## ######### # ### ### ### #
#R                                     #
########################################