########################################
#       P      #             #         #
# ############ ##### ####### # #### ## #
#              #    B      #        ## #
## ####### ### ########### ## ######## #
#    @    .#               #  #        #
# ### #### # # ############## #### ### #
#          #                  #  O     #
# ######### ## ######### # ### ### ### #
#R                                     #
########################################