########################################
#    R                          B      #
##    #   #    ##    #  ##   ###  #   ##
# #  #   # #   # #   #  # #  #     # # #
#  ##   #   #  #@ #  #  #  # ###    #  #
#  ##   #####  #   # #  # #  #     # # #                                  
#  ##  #     # #    ##  ##   ###  #   ##
#   O                           P      #
########################################