########################################
#              #             #         #
# ############ ##### ####### ###### ## #
#         R    #           #        ## #
## ####### ### ########### ## ######## #
#    @    .#               #  #        #
# ### #### # # ############## #### ### #
#          #                  #        #
# ######### ## ######### ######### ### #
#                        #             #
########################################