###########
#R       #
#        #
#        #
#        #
#        #
#@       #
#        #
###########