########################################
#              #             #         #
# ############ ##### ####### ###### ## #
#         R    #           #   O    ## #
## ####### ### ########### ## ######## #
#    @    .#               #  #        #
# ### #### # # ############## #### ### #
#          #         B        #        #
# ######### ## ######### ######### ### #
#P                       #             #
########################################