#########################
#          #            #
#      R   #     @      #
#          #            #
#          #            #
#          #            #
#          #            #
#          #####        #
#                       #
#                       #
#                       #
#                       #
#########################