########################################
#    R                          B      #
#:    :   ;    ;;    ;  ;;   ;;;  ;   ;#
# :  :   ; ;   ; ;   ;  ; ;  ;     ; ; #
#  ::   ;   ;  ;@ ;  ;  ; ;  ;;    ; ; #
#  ::   ;;;;;  ;   ; ;  ; ;  ;     ; ; #
#  ::  ;     ; ;    ;;  ;;   ;;;  ;   ;#
#   O                           P      #
########################################